11 11 5 8 2.

##########
#      ###
######   #
#        #
##  ##  ##
#        #
#        #
#  #  #	 #	
# ##  ## #
##########